NO ./textures/bluestone.xpm
SO ./textures/purplestone.xpm

WE ./textures/wood.xpm
EA ./textures/wall_1.xpm
F 220,100,0
C 225,30,0

11111111111111111111
1011111N
1111111111
