NO ./textures/north.xpm
SO ./textures/south.xpm
WE ./textures/west.xpm
EA ./textures/east.xpm

F 220,100,0
C 225,30,0

11111111111111111111
10000000001100000001
10110000011100000001
10010000000000000001
11111111101100000111
10000000000000000001111
10110000001111100000001
10010000001   1000N0001
11111111111   111111111
