NO ./textures/bluestone.xpm
SO ./textures/purplestone.xpm

WE ./textures/wood.xpm
EA ./textures/wall_1.xpm
F 220,100,0
C 225,30,0

11111111111111111111
10000000001100000001
10110500011100050001
100100500W4000000001
11111111141100000111
10005000000000500001111
10110000001111100000001
10010000001   100000001
11111111111   111111111
