NO ./textures/bluestone.xpm
SO ./textures/purplestone.xpm

WE ./textures/wood.xpm
EA ./textures/wall_1.xpm
F 220,100,0
C 225,30,0

11111111111111111111
10000000001100000001
10110500011100000001
100100000N4000050001
11111111101100000111
10000000000000000001111
10110500001111100050001
10010000001   100000001
11111111111   111111111
